きしつ	機室	名詞	
fとうめし	F棟飯	名詞	
おとこのこ	男の娘	名詞	
とき	瞬間	名詞	
めがあうとき	目が逢う瞬間	名詞	
おりたたみがさ	折りたたみ傘	名詞	
/	･	名詞	
はるがっき	春学期	名詞	
あきがっき	秋学期	名詞	
こうしん	恒真	名詞	
ぞくする	∈	名詞	
x	×	名詞	
いいぞ	いいゾ	名詞	
いみわから	意味分から	名詞	
らてふ	LaTeX	名詞	
てx	TeX	名詞	
tex	TeX	名詞	
ぁてx	LaTeX	名詞	
latex	LaTeX	名詞	
おしめん	推しメン	名詞	
そうほうさい	雙峰祭	名詞	
がぶっこわれた	我物故割れた	名詞	
まどまぎ	まどマギ	名詞	
おせんべい	〄	名詞	
かいに	改ニ	名詞	
かんむす	艦娘	名詞	
しゅんてい	瞬停	名詞	
ばくたん	爆誕	名詞	
さえぐさきい	冴草きい	名詞	
おとしろせいら	音城セイラ	名詞	
まる	ﾟ	名詞	
はんだくてん	ﾟ	名詞	
だくてん	ﾞ	名詞	
とういこうぶん	糖衣構文	名詞	
めたる	🤘	名詞	
おーけー	🙆	名詞	
じゆうりっしく	自由律詩句	名詞	
しょうり	😤	名詞	
